1 30 9
5 10 8 2 7 6 5 2 7 10 8
5 10 7 2 6 6 5 2 6 10 7
5 10 7 2 6 6 5 2 6 10 7
4 2 7 10 6 6 5 12 6
7 2 7 2 6 8 5 1 3 5 4 8 5 4 6
7 2 7 2 6 8 5 1 3 5 4 8 5 4 6
7 4 6 4 5 4 4 1 3 5 4 8 5 4 6
5 8 5 4 4 6 3 6 4 6 5
5 8 5 5 4 5 3 6 4 6 5
3 14 4 4 3 12 4
3 14 4 4 2 12 4
3 14 3 4 2 12 4
3 14 3 4 2 12 4
3 14 3 5 1 11 3
3 12 2 7 1 11 2
3 12 2 7 0 11 2
3 12 1 7 0 11 2
3 12 1 7 0 11 1
1 20 1