1 30 10
5 10 9 2 8 6 5 2 8 10 9
5 10 8 2 7 6 5 2 7 10 8
5 10 8 2 7 6 5 2 7 10 8
4 2 8 10 7 6 5 12 7
8 2 8 2 7 8 6 2 4 1 2 3 1 8 6 4 7
8 2 8 2 7 8 6 2 4 1 2 3 1 8 6 4 7
8 4 7 4 6 4 5 2 4 1 2 3 1 8 6 4 7
6 8 6 4 5 2 4 4 3 6 5 6 6
7 8 6 4 5 1 6 1 4 4 3 6 5 6 6
5 12 5 1 6 1 4 4 3 12 5
6 12 5 2 6 1 2 1 3 2 2 12 5
3 14 4 4 2 12 4
3 14 4 4 2 12 4
3 14 4 5 1 11 3
3 12 3 7 1 11 3
3 12 3 8 0 10 2
3 10 2 10 0 10 2
4 10 2 9 0 1 1 10 2
1 30 2